20 4

S10 S0 S0 S0
S0 C15 S0 S0
V10 S0 S0 S0
A8 S0 S0 S0 
S0 S0 S0 V15
S0 S10 S0 S0
S0 S15 S0 S0
S0 S10 S0 S0
V10 S0 S0 S0
S0 H20 S0 S0
S0 S0 V10 S0
S0 S0 S0 H20
A10 S0 S0 S0
S0 C20 S0 S0
S0 S0 A10 S0
S0 S0 S0 C20
S0 S10 S0 S0
S0 S20 S0 S0
S0 H30 S0 S0
S0 S35 S0 S0